################
#      @    #  #
#           #XX#
#           #  #
#              #
#              #
#              #
#              #
#             G#
#              #
#              #
#              #
#              #
#              #
#C            C#
################
