################
#      d d d   #
#      d  d    #
#   C    V  @  #
#       d      #
#     d d d s V#
###   d d d  ###
#L     XX     G#
###          ###
#              #
#              #
#   d     dd   #
#   d  V       #
#C            C#
#CC   #L#    CC#
################
