################
#              #
#              #
#   C    V  @  #
#              #
#      C      V#
###          ###
#L     XX     G#
###          ###
#              #
#              #
#   d     dd   #
#   d  V       #
#C            C#
#CC   #L#    CC#
################
