################
#      #G# L   #
#      LGG     #
#   C    V  @  #
#       d      #
#     s       V#
###          ###
#L     XX     G#
###          ###
#              #
#              #
#   d     dd   #
#   d  V       #
#C            C#
#CC   #L#    CC#
################
